hartevelt	prof dr p korteweg
perla relkin	pablo granda
kenzelmann	da tennant
priyamvada chandra	kim l r brouwer
james ford	tristan pearce
barry smit	h carolyn peach brown
j j j smit	r ramdat misier
p p h delnoy	r ramdat misier
luca modenese	andrew phillips
els van hoffen	maarten pennings
barry smit	mark w skinner
brenda parlee	chris furgal
elvan	r ramdat misier
bridget martin	barry smit
jean vasseur	bertrand broyart
roland notaina	barry smit
adam kudlak	barry smit
tara holland	barry smit
nicole rogalla	michael r w amler
peter wiegand	rachel klein
j j smit	p h f morshuis
p smeibidl	hofmann
fuxing tang	ronald borchardt
bill patrick kudlak	tristan pearce
adiyaman	r ramdat misier
barry smit	mark andrachuk
brad potts	matthew j larcombe
olufunso somorin	h carolyn peach brown
