hartevelt	tristan pearce
perla relkin	cl mence bernard
kenzelmann	da tennant
priyamvada chandra	kim l r brouwer
james ford	amanda caron
barry smit	h carolyn peach brown
j j j smit	ghani
p p h delnoy	adiyaman
luca modenese	andrew phillips
els van hoffen	joost j smit
barry smit	mark w skinner
brenda parlee	chris furgal
elvan	ghani
bridget martin	tristan pearce
jean vasseur	bertrand broyart
roland notaina	harold wright
adam kudlak	harold wright
tara holland	barry smit
nicole rogalla	michael r w amler
peter wiegand	rachel klein
j j smit	p h f morshuis
p smeibidl	hofmann
fuxing tang	kazutoshi horie
bill patrick kudlak	harold wright
adiyaman	ghani
barry smit	mark andrachuk
brad potts	matthew j larcombe
olufunso somorin	h carolyn peach brown
