hartevelt	adam lindgreen
perla relkin	rabah boukra
kenzelmann	v kurbanova
priyamvada chandra	nicole rogalla
james ford	v kurbanova
barry smit	rabah boukra
j j j smit	rabah boukra
p p h delnoy	michael r w amler
luca modenese	rabah boukra
els van hoffen	v kurbanova
barry smit	michael r w amler
brenda parlee	visser
elvan	rabah boukra
bridget martin	reina bendayan
jean vasseur	rabah boukra
roland notaina	raymond h pieters
adam kudlak	raymond h pieters
tara holland	michael r w amler
nicole rogalla	michael r w amler
peter wiegand	michael r w amler
j j smit	rabah boukra
p smeibidl	michael r w amler
fuxing tang	nicole rogalla
bill patrick kudlak	tristan pearce
adiyaman	rabah boukra
barry smit	tristan pearce
brad potts	reina bendayan
olufunso somorin	v kurbanova
